Rank,NOC,Gold,Silver,Bronze,Total,Year
1,United States,40,44,42,126,2028
2,China,40,27,24,91,2028
3,Japan,20,12,13,45,2028
4,Australia,18,19,16,53,2028
5,France,16,26,22,64,2028
6,Netherlands,15,7,12,34,2028
7,Great Britain,14,22,29,65,2028
8,South Korea,13,9,10,32,2028
9,Italy,12,13,15,40,2028
10,Germany,12,13,8,33,2028
11,New Zealand,10,7,3,20,2028
12,Canada,9,7,11,27,2028
13,Uzbekistan,8,2,3,13,2028
14,Hungary,6,7,6,19,2028
15,Spain,5,4,9,18,2028
16,Sweden,4,4,3,11,2028
17,Kenya,4,2,5,11,2028
18,Norway,4,1,3,8,2028
19,Ireland,4,0,3,7,2028
20,Brazil,3,7,10,20,2028
21,Iran,3,6,3,12,2028
22,Ukraine,3,5,4,12,2028
23,Romania,3,4,2,9,2028
24,Georgia,3,3,1,7,2028
25,Belgium,3,1,6,10,2028
26,Bulgaria,3,1,3,7,2028
27,Serbia,3,1,1,5,2028
28,Czech Republic,3,0,2,5,2028
29,Denmark,2,2,5,9,2028
30,Azerbaijan,2,2,3,7,2028
30,Croatia,2,2,3,7,2028
32,Cuba,2,1,6,9,2028
33,Bahrain,2,1,1,4,2028
34,Slovenia,2,1,0,3,2028
35,Chinese Taipei,2,0,5,7,2028
36,Austria,2,0,3,5,2028
37,Hong Kong,2,0,2,4,2028
37,Philippines,2,0,2,4,2028
39,Algeria,2,0,1,3,2028
39,Indonesia,2,0,1,3,2028
41,Israel,1,5,1,7,2028
42,Poland,1,4,5,10,2028
43,Kazakhstan,1,3,3,7,2028
44,Jamaica,1,3,2,6,2028
44,South Africa,1,3,2,6,2028
44,Thailand,1,3,2,6,2028
47,Ethiopia,1,3,0,4,2028
48,Switzerland,1,2,5,8,2028
49,Ecuador,1,2,2,5,2028
50,Portugal,1,2,1,4,2028
51,Greece,1,1,6,8,2028
52,Argentina,1,1,1,3,2028
52,Egypt,1,1,1,3,2028
52,Tunisia,1,1,1,3,2028
55,Botswana,1,1,0,2,2028
55,Chile,1,1,0,2,2028
55,Saint Lucia,1,1,0,2,2028
55,Uganda,1,1,0,2,2028
59,Dominican Republic,1,0,2,3,2028
60,Guatemala,1,0,1,2,2028
60,Morocco,1,0,1,2,2028
62,Dominica,1,0,0,1,2028
62,Pakistan,1,0,0,1,2028
64,Turkey,0,3,5,8,2028
65,Mexico,0,3,2,5,2028
66,Armenia,0,3,1,4,2028
66,Colombia,0,3,1,4,2028
68,Kyrgyzstan,0,2,4,6,2028
68,North Korea,0,2,4,6,2028
70,Lithuania,0,2,2,4,2028
71,India,0,1,5,6,2028
72,Moldova,0,1,3,4,2028
73,Kosovo,0,1,1,2,2028
74,Cyprus,0,1,0,1,2028
74,Fiji,0,1,0,1,2028
74,Jordan,0,1,0,1,2028
74,Mongolia,0,1,0,1,2028
74,Panama,0,1,0,1,2028
79,Tajikistan,0,0,3,3,2028
80,Albania,0,0,2,2,2028
80,Grenada,0,0,2,2,2028
80,Malaysia,0,0,2,2,2028
80,Puerto Rico,0,0,2,2,2028
84,Cabo Verde,0,0,1,1,2028
84,Ivory Coast,0,0,1,1,2028
84,Peru,0,0,1,1,2028
84,Qatar,0,0,1,1,2028
84,Refugee Olympic Team,0,0,1,1,2028
84,Singapore,0,0,1,1,2028
84,Slovakia,0,0,1,1,2028
84,Zambia,0,0,1,1,2028